1	2	7	8	8	
7	9	5	2	6	
5	4	6	3	G	
3	6	3	6	7	
S	8	1	5	3	
