2	9	3	4	3	4	5	4	5	7	2	7	1	5	6	8	9	5	8	2
8	1	6	1	2	7	4	5	4	8	3	2	3	3	5	8	7	1	7	9
8	2	3	9	3	9	5	6	9	4	9	6	7	4	9	9	4	4	7	1
5	6	1	2	9	9	1	2	7	6	7	1	3	8	8	2	4	3	6	4
6	5	G	3	9	5	8	2	9	9	9	1	1	5	3	1	1	6	7	5
9	5	5	7	1	7	6	7	9	8	4	2	2	3	2	3	1	3	5	9
3	5	5	8	4	1	6	4	7	8	9	9	3	6	4	7	1	2	9	7
4	1	S	3	3	5	1	5	5	4	3	5	5	4	1	2	2	4	5	5
1	2	4	7	6	6	8	4	5	2	6	2	5	6	3	3	3	1	4	8
9	1	7	6	3	7	5	1	1	3	4	2	1	9	2	8	4	1	4	5
9	4	7	7	5	7	9	3	3	9	4	7	3	6	5	7	5	9	2	4
5	6	6	5	8	8	3	6	3	8	5	7	6	5	2	2	9	5	6	2
8	3	5	2	7	4	4	7	7	4	4	9	5	8	8	4	5	4	9	5
5	8	4	4	7	8	7	2	7	5	4	6	1	6	3	4	7	6	9	6
2	3	9	4	7	9	8	8	1	8	3	5	7	4	1	8	6	6	6	8
3	3	3	9	6	8	7	4	6	7	3	1	5	5	1	5	1	1	1	9
1	2	4	2	7	8	2	8	4	9	8	2	4	5	7	1	7	8	7	6
2	5	3	1	8	6	2	8	5	1	5	5	1	9	9	5	1	6	9	5
7	4	6	5	1	8	1	7	5	6	8	5	2	7	5	9	1	2	3	9
6	1	2	9	5	1	2	9	3	4	6	5	1	4	7	5	5	8	1	3
