9	7	3	1	9	9	2	4	6	2	9	8	9	4	2
9	9	4	1	5	6	2	1	7	3	4	9	5	9	1
1	3	7	2	1	6	1	5	9	1	2	1	2	1	5
4	5	3	4	8	6	1	2	6	7	2	7	8	1	9
3	7	6	1	4	2	9	3	7	6	5	1	6	9	5
6	5	5	7	5	4	6	8	7	8	4	7	8	8	5
9	6	7	2	7	7	7	1	6	5	5	G	4	1	8
8	1	1	4	8	6	1	3	6	2	9	2	9	9	1
3	4	6	2	5	3	1	3	1	6	1	2	5	9	3
7	1	3	9	2	1	5	2	9	1	7	5	5	9	6
2	1	5	5	5	8	1	8	4	1	1	3	5	5	2
6	2	3	S	4	3	8	6	7	9	4	7	3	3	8
1	4	6	3	3	3	9	1	1	5	2	5	6	5	5
3	2	7	4	9	1	6	6	2	9	7	9	3	1	4
3	8	5	4	6	5	9	1	1	2	8	8	5	9	1
