9	7	7	2	7	2	8	7	3	8	9	9	4	8	1	5	9	2
5	9	9	3	G	4	6	5	8	2	4	6	2	4	1	8	1	4
4	9	5	4	3	2	9	8	9	7	3	9	5	7	9	1	7	7
4	3	3	1	7	1	4	2	6	4	6	5	5	6	6	7	6	4
8	8	2	1	8	4	5	8	3	9	7	8	7	3	4	6	1	2
2	3	4	9	8	6	9	3	6	6	5	8	6	9	9	4	4	2
9	6	3	9	7	8	5	9	1	9	5	5	2	9	1	9	4	5
1	6	7	5	9	1	7	4	1	6	8	1	5	2	1	6	5	2
5	7	6	8	9	8	5	1	7	6	2	1	7	1	6	1	8	3
8	7	7	5	7	8	2	6	3	2	1	6	7	2	2	2	8	5
3	4	5	2	5	8	7	5	2	5	5	8	9	5	4	7	1	5
9	8	9	1	7	1	3	8	3	2	3	6	3	5	4	2	2	1
4	5	6	3	2	6	3	2	5	7	7	4	3	3	6	1	8	6
3	2	3	4	1	5	6	5	9	2	4	8	8	2	9	3	4	9
4	1	8	8	8	7	5	7	6	6	4	9	2	9	1	4	2	5
5	8	1	9	4	3	8	4	4	1	1	7	9	2	4	3	4	6
5	4	8	6	3	2	6	8	2	7	6	9	4	9	4	8	3	6
7	S	2	5	8	3	8	2	2	5	9	9	8	1	8	7	1	1
